# ignore case
# strip trailing and leading spaces
# if you need to include spaces, place the word or phrase inside ' ' or " "
# to simply remove a word when it appears, simply place '' or "" after the equal sign    

a gente tem = temos
a gente veio = viemos
a gente vai = vamos
a gente está = estamos
a gente pode = podemos
a minha = minha
a minha coisa = o que eu faço				# 'my thing'
a meu = ao meu
a meus = aos meus
a minha = à minha
a minhas = às minhas
a que horas = que horas
a seu = ao seu
a seus = aos seus
à você = a você
absolutamente errado = totalmente errado
acalme-se = calma
acontece que = é que
acredite em mim = acredite
adeus a = tchau para
adeus = tchau
agora sim = agora, sim
ai está = aí está
ai esta = aí está
aí vem = lá vem
ainda, não = ainda não
alguma coisa = algo
apenas = só
apresse-se = rápido
aqui entre nós = cá entre nós
as vezes = às vezes

boa-fé = boa fé
bye bye = tchau
bye, bye = tchau
bye = tchau

cecause = porque				# é como o Google Translator traduz 'because
certo ou não? = certo?
completamente = totalmente
certamente = com certeza
cheio de pessoas = cheio de gente
claro, claro, claro = claro, claro
claro claro claro = claro, claro
coloca = põe
colocando = pondo
colocar = pôr
colocam = põem
colocou = pôs
colocamos = pusemos
colocaram = puseram
colocá-lo = botá-lo
colocá-la = botá-la
colocá-los = botá-los
colocá-las = botá-las
coloco = ponho
coloque = ponha
coloquem = ponham
coloquei = pus
como é que eu vou saber? = como vou saber?
como eu vou saber? = como vou saber?
como eu estou = como estou
como eu poderia explicar = como posso explicar
conosco = com a gente
cuidarei = cuido

de a = da
de as = das
de o = do
de os = dos
de ser tão = de ser			# deixe/pare de ser tão chato --> deixe/pare de ser chato
deixe de ser tão = não seja
depois eu = depois
depois nós = depois
desapontado = decepcionado
desta = dessa
destas = dessas
deste = desse
destes = desses
dignamente = com dignidade
disse que iria = disse que ia
disto = disso
do que você está falando? = do que está falando?
doña = dona

é que acontece que = é que
é realmente = é muito
e tudo isso. = e tudo mais.
eles tem = eles têm
em a = na
em as = nas
em o = no
em os = nos
em meu = no meu
em meus = nos meus
em minha = na minha
em minhas = nas minhas
em seu = no seu
em seus = nos seus
em sua = na sua
em suas = nas suas
em nosso = no nosso
em nossos = nos nossos
em nossa = na nossa
em nossas = nas nossas
em ti = em você
encontrar com = encontrar
encontrou com = encontrou
encontrei com = encontrei
encontramos com = encontramos
encontra com = encontra
encontram com = encontram
encontrava com = encontrava
encontravam com = encontravam
encontrávamos com = encontrávamos
encorajar = incentivar
encorajo = incentivo
encoraja = incentiva
encorajamos = incentivamos
encorajei = incentivei
encorajaram = incentivaram
encorajava = incentivava
encoravajam = incentivavam
encorajávamos = incentivávamos
encoraje = incentive
encorajemos = incentivemos
então, = então
então por favor = então, por favor
então se = então, se
era só o que me faltava = só faltava essa
especialmente = principalmente
esperando por nós = nos esperando
espere por mim = me espera
espera por mim = me espera
esperando por mim = me esperando
esperou por mim = me esperou
esperaram por mim = me esperaram
espera por nós = nos espera
esperar por nós = nos esperar
esperou por nós = nos esperou
esperaram por nós = nos esperaram
esperando por você = te esperando
espero por você = te espero
esperei por você = te esperei
espere por mim = me espere
estamos condenados. = estamos ferrados.
estamos fechados por hoje. = já fechamos.
estamos nós = estamos
esta = essa
estas = essas
estás = está
este = esse
estes = esses
está me ocorrendo uma ideia = estou tendo uma ideia
esteve por tão pouco tempo = esteve tão pouco tempo
eu ainda = ainda
eu cuidarei disso = eu cuido disso
eu entendo isso = eu entendo
eu estou indo = vou
eu lhe asseguro = te garanto
eu não = não
eu não posso acreditar = não acredito
eu não vou = não vou
eu preciso = preciso
eu quero = quero
eu sei perfeitamente = sei muito bem
eu sei muito bem que = sei muito bem que
eu sinto muito por = sinto muito por
eu sinto muito pelo = sinto muito pelo
eu sinto muito pelos = sinto muito pelos
eu sinto muito pelas = sinto muito pelas
eu tenho que = tenho que
eu te asseguro = te garanto
eu te digo uma coisa = te digo uma coisa
eu vou = vou
existe esse = existe um
existe essa = existe uma

faça um favor para mim = faça um favor
falar sobre isso = falar disso
fato plano = fato inegável
fazendo calor = calor
fazendo muito calor = muito calor
fazendo frio = frio
fazendo muito frio = muito frio
felizes os olhos que te veem = que alegria te ver
fico feliz que você = fico feliz que
foi para isso que você veio = você veio para isso
foi para isso que eu vim = eu vim para isso
foi realmente = foi muito
foram realmente = foram muito

, hein? = .
honestamente = sinceramente

independente de tudo = independente de qualquer coisa
inteira = toda
inteiras = todas
inteiro = todo
inteiros = todos
irei = vou
iremos = vamos
isso é o que importa = isso que importa
isso não é = não é
isto = isso

lei do murphy = lei de Murphy
leva algum tempo = leva um tempo
levamos algum tempo = levamos um tempo
levar algum tempo = levar um tempo
levaram algum tempo = levaram um tempo
levei algum tempo = levei um tempo
levou algum tempo = levou um tempo
lhe cai muito bem. = combina muito com você.

mamãe = mãe
maneira = forma
'mas às vezes ' = 'mas, às vezes, '
mas você não acha = mas não acha
me desculpe por me intrometer = desculpe me meter
melhor do que = melhor que
melhores do que = melhores que
meu problema. = problema meu.
meu nome é o = meu nome é
meu nome é a = meu nome é
mt = muito
mta = muita

nao = não
não, é que = é que
não, então = então
não não não = não, não
não, não, não = não, não
não admira = não surpreende
nao e? = não é?
nao é? = não é?
não e? = não é?
não está? = não é?
não posso acreditar = não acredito
não seja tão = não seja
não tema = não tenha medo
não tinha más intenções. = não fez por mal.
não vou demorar = não demoro
ne? = não é?
né? = não é?
nesta = nessa
nestas = nessas
neste = nesse
nestes = nesses
nisto = nisso
nós não = não
nós nunca = nunca
nós temos = temos
nós vamos = vamos
novamente = de novo
numa hora. = em uma hora.			# para reverter em uma hora --> numa hora feito por outra função
num vou = não vou
num vai = não vai
num vamos = não vamos
nunca mais. Sempre = nunca mais. Nunca				# 'Never. Ever.'

o que acontece é que = acontece que
o que aconteceu? = o que houve?
o que diabos = que diabos
o que você está fazendo? = o que está fazendo?
o que você acha = o que acha
o que você está = o que está
'oi ' = 'oi, '
'olá ' = 'olá, '
ok. = certo.
o.k. = certo
ok = certo
okay = certo
onde nós estávamos = onde estávamos
onde eu estou = onde estou
os nossos = nossos
opah = opa
, ou o quê? = ?				# muito comum no espanhol colombiano 'o qué?'
ou o quê? = ?				# muito comum no espanhol colombiano 'o qué?'

papai = pai
para onde = aonde
peraí = espera aí
perdão perdão = perdão, perdão
pessoas de bem = gente de bem
pode acreditar? = acredita?
'por favor ' = 'por favor, '
por que? = por quê?
porque? = por quê?
porque se não o fizermos = senão
posso fazer uma pergunta? = posso perguntar uma coisa?
posso tê-lo? = posso ficar com ele?
pra = para
precisamente = justamente
pro = para o
prazer em conhecê=lo = muito prazer
prazer em conhecê=la = muito prazer
preciso que você = preciso que
procurei por = procurei
procura por = procura
procurado por = procurado
procuramos por = procuramos
procuraria por = procuraria
procuraríamos por = procuraríamos
procuraram por = procuraram
procurava por = procurava
procurávamos por = procurávamos
procuro por = procuro
procurou por = procurou

qualquer que seja = que seja
quem é que = quem
quero que eles = quero que
quando ele descobriu = quando ele soube
qual o seu nome? = qual é o seu nome?
que? = quê?
que bom que você tenha gostado = que bom que gostou
quem foi que = quem

realmente vai = vai mesmo		# Ela realmente vai viajar. --> Ela vai mesmo viajar.
repetidamente = sem parar

são realmente = são muito
se apresse = depressa
se contenha = contenha-se
se contenham = contenham-se

se não fosse pela = se não fosse a
se não fosse pelas = se não fossem as
se não fosse pelo = se não fosse o
se não fosse pelos = se não fossem os
é seu problema = é problema seu
, sim ou não? = ?
sim ou não? = certo?
sim sim sim = sim, sim
sim, sim, sim = sim, sim
sim sim sim. = sim, sim.
sim, sim, sim. = sim, sim.
'sim ' = 'sim, '
Só isso que faltava = Só faltava essa
só para você ter uma ideia = para você ter uma ideia
só vou te dizer que = só te digo que
sobretudo = principalmente
somente = só

tá? = está bem?
tá = está
ta = está
ta bom = está bem
tá bom = está bem
ta bem = está bem
tá bem = está bem
tão facilmente = tão fácil
tava = estava
tavam = estavam
tenho umas desculpas para lhe oferecer = tenho que te pedir desculpas
to = estou
tô = estou
todas minhas = todas as minhas
todas nossas = todas as nossas
todas suas = todas as suas
todos meus = todos os meus
todos nossos = todos os nossos
todos os dias = todo dia
todos seus = todos os seus
tudo o que = tudo que

um fato plano = algo inegável
upa = opa

você está totalmente certa. = você tem toda a razão.
você está totalmente certo. = você tem toda a razão.
você não pode imaginar = você não imagina
você sabe o que eu acho? = sabe o que eu acho?
você vai me fazer um favor? = me faz um favor?

yeah, = sim,
yeah. = sim.
yeah = sim
yeah! = sim!

zzz = ''

#### ORTOGRAFIA
açucar = açúcar
blz = beleza
hj = hoje
nao = não
tambem = também
voce = você
voces = vocês
vc = você
vcs = vocês


#### INTERJEIÇÕES
uau = nossa
'puxa ' = 'puxa, '
puxa = poxa
hein = ''


#### CARACTERES
“ = "
” = "
'  ' = ' '
♪ = ''
♪ = ''